{
  "steps": 14,
  "maze": [
    "##########",
    "#A@@.#...#",
    "#.#@##.#.#",
    "#.#@##.#.#",
    "#.#@@@@#B#",
    "#.#.##@#@#",
    "#....#@@@#",
    "##########"
  ] 
}