{
  "steps": 219,
  "solution": [
    "###############B#############################################",
    "##.....########@#...................................@@@#...##",
    "##.###.#@@@@@@@@####################################@#@#.#.##",
    "##.###.#@#########@@@@@@@@@@#########@@@@@@@########@#@#.#.##",
    "##.#####@@@@@@@@@@@########@#.......#@#####@########@#@#.#.##",
    "##.########################@#.#####.#@#...#@########@#@#.#.##",
    "##@@@@@@@@@@@@@@@@@@@@@@@@@@..#####.#@##.##@########@#@#.#.##",
    "##@###.############################.#@##.##@########@#@#.#.##",
    "##@###.##...#...#...#...#...#.......#@##.##@########@#@#.#.##",
    "##@###....#...#...#...#...#...#######@##.##@########@#@#.#.##",
    "##@##################################@##.##@########@#@#.#.##",
    "##@@@@@@@@@@@@@@@@@@@@@@@@@@@@@@@@@@@@...##@########@#@#.#.##",
    "###########################################@########@#@#.#.##",
    "###...............................#########@@@@@@@@@@#@#.#.##",
    "########################.###########################.#@#.#.##",
    "#........................#...........................#@#.#.##",
    "#.######################.#############################@#.#.##",
    "#.#..........#@@@@@@@@@@@@@@@@@@@@@@@@@@@@@@@@@@@@@@@@@#.#.##",
    "#.#.########.#@#########################################.#.##",
    "#.#........#.#@#.........................................#.##",
    "#.##########.#@#.#########################################.##",
    "#............#@#.##........................................##",
    "##############@#.#############################.#####.########",
    "#.............@@@@@@@@@@@......................#####........#",
    "########################A####################################"
  ]
}