{
  "steps": 302,
  "solution": [
    "#######################################################################################################################################################################################",
    "#A......#.....#.....#.#.....#.#...#.#.......#.....#.#...#.......#...........#...#.............#.....#.......#.........#.....#.....#...........#.#...................#.....#...........#",
    "#@#######.#.#.#.###.#.#####.#.#.#.#.#####.#.#.###.#.#######.#.###.#.#.#.#.#####.#.#########.#.###.#.#.#.#.#.#.#.#.###.#.#####.#.#.#.#.#.#.#.#.#.#.#.###.#####.#.#.#.#.#.#.#.#.#.#.#.#.#",
    "#@....#.#.....#.#...#.......#.......#...#...#.#.......#.....#.....#.........#...#...#.....#.........#.#...#.#.#.#.#...#.#...#.....#...#...#...#.#...#.#.#.#...........#.#.......#.#...#",
    "#@#####.#.#.#.#.#.###.###.#.###.#.#.#.###.#.#.#.#.#.#.###.#.#.#######.#.#.#.###.#.#.#.#.#######.#.###.###.#.#.###.#####.#.#.#.#####.###.#.#.#########.#.#.#.###.#####.#.#.#####.#.#.###",
    "#@..#...#.#.#.....#...#.............#.#.......#.......#.#...#.#.........#.......#.#.....#.......#.......................#.#...#.#.#...#...#.#.#...#...#.......#.........#...#.#.....#.#",
    "#@#.###.#.#.#.#.#.#.#.#.#.###.#.#.#.#.#.###.###.###.#.#.#.#.###.###.###.#.#.#####.#.#.#.#.#.#.#.#.###.#.###########.#.#.#.#.#.#.#.###.###.#.#.#.#.#.#.#.#.#.#.#####.###.#.###.#.#####.#",
    "#@@@#...#...#...#.#.#.#...#...#...#...#.....#...................#...#.#.....#...........#.....#.#.#...#.#...#.........#.#.......#...........#...#.....#...#.#...............#.#.......#",
    "#.#@#.#.###.#.#.###.#######.#.#.#.#.#.#.###.#.###.#.#.#.###.#.#.#.#.#.#.#####.#.#.###.#.#.###.#.#.#.#.#.###.###.#.#.#.#####.#.###########.#.#.#.#########.#.#.###.###.###.#.#.###.#.#.#",
    "#.#@@@......#@@@#.....#.....#.#...#...#.....#...............#...#.......#.#.#.......#.#...#.....#.#.#.........#.#.........#...#...#.........#.#...#.#.#...........#.....#.......#.....#",
    "#.#.#@#.#.###@#@#.#.#.#.#.###.#########.#.#.###.#.#.#####.#####.#.#####.#.#.###.#.#.#.#.#.#.#.#.#.#.#.#.#.###.###.###.#.#.###.###.#.#.#.#.#.###.#.#.#.#.#.#####.###.#.#.#######.#.###.#",
    "#...#@@@@@@@@@#@..#.#...#.#.#...........#.#.#...........#.......#.#.#.....#...#.#.#.#...#.......#.........#...#.....#...#.....#.#.....#.#...#.....#.#...#.....#.#.#.#.............#...#",
    "#.#.###########@###.#.###.#.#####.#.#.#.###.#.###.#.#.#.#########.#.#.#####.#.#.#.#.#.#.#####.#.#.#.###.#.#.#.#.###############.#.###.#.#.#.#.#.###.###.#.#.#.#.#.#.#####.#.#.###.#.###",
    "#.....#.#......@....#.#.............#.#...........#.....#.#.....#...#.#.#.#...........#.#.....#...#.....#...#.....#...........#.#.#...#.........#.#.....#...#.......#.....#...#.......#",
    "#####.#.#.#.#.#@#####.#.#####.#.#.#.#.###.#.#.###.#######.#.#.#####.#.#.#.#.#.#####.###.#.###.#.#.#.#####.#.#.###.#.###.#.###.#.#.###.#.###.###.#.#.#.#.###.#.#####.#.#.#.#####.#.###.#",
    "#.....#.#.....#@#.......#.......#.....#...#...#...............#.....#...........#.........#.....#.#.#.............#.#...#.#.....#.#...#...#...#.........#.....#...#...#...........#...#",
    "#.#.#.###.#.###@#.#.#.###.#.###.#.#.#.###.###.#.###.#.#.#.#####.#.#.#.###.#####.#####.#.#.#.###.#.###.###.#####.#.#.#.#.#.###.###.#.###.#.#.#.#.#.#####.#####.#.#.#.###.#.#.#.#####.###",
    "#...#.....#.#..@@@..#.....#.#.....#...#...#.#.#.....#...#.#...#.#.....................#.....#.....#.....#.......#.........#...#...#...#.#.#.#...#.#.#...#...#.....#.#.......#...#.....#",
    "#####.###.###.#.#@#.#.#.#.###.#.#.#.#####.#.#.#.#.#.#######.#.#.#.#.#.#######.###.#.###.#.#.###.#.#.#.#.#.#####.#.#.#.###.#.###.###.#.###.#.###.#.#.#.#.###.#.###.###.#####.###.#.#####",
    "#.....#.....#...#@@@..#.#...#...#.........#...................#.....#...#.........#.....#...........#...#.#.......#.#...#...#...............#.......#...#.........#.............#.....#",
    "#.#.#.#.#######.#.#@#########.#######.###.#####.###.#.###.#.#######.#.###.#.###.###.###.#####.#####.###.#.#.#.#.#.#.#.###.#.#.#######.#.#.#.#.#.#.#.#.#####.#.#.#.#.#.#.###.#.#.###.#.#",
    "#.#.#.......#...#.#@@@#.......#.................#.....#...#.......#.#.....#.....#.#...#.#.....#...#.#.......#...#.....#.....#.....#.......#.....#...#.#...#.....#...#.#.#...#...#.....#",
    "###.#.#####.#.###.###@#.#.###.#.###.#####.#.#.#######.#.#########.#####.#.#.#.###.#.#.#.###.#######.#.#########.#.#.#.#.#.#.#####.###.###.###.#.#.#.#.#.#.#.###.#.#.#.#.#####.#.#.###.#",
    "#.#...#.....#.....#.#@@@@@#...#...#.#...#...#.#.#.#.....#.....#.#.#.#.....#.................#.#.#...#...#...#.#.#.#.#.#...#...#.#.............#.#...#...#.#.#.......#.........#.#.....#",
    "#.###.#.###.#.#.#.#.###.#@#.###.#####.#.###.#.#.#.#.#.###.#.#.#.#.#.#.#.#.#.#.#####.###.#.###.#.#.###.#.#.#.#.#.#.#.#.#.###.#.#.###.#.#.#.#######.#.###.#.#.#.###.#.#.#.###.###.#.#.#.#",
    "#.#...#.....#.....#.#...#@@@#@@@@@..#...#.....#.#.#.....#.#...#...#...#.#.........#.....#...#.#...#...#...#.#.#.......#...#.#...#...#.#...#.....#.......#.......#.#.....#.#...#.#.....#",
    "#.#.#.#.#.#.#.###.#.###.#.#@#@###@###.#.#.###.###.#.#.#.#.###.#.#.#.#.#.#.#########.#.#.#.#.#.#######.#.###.#.#.#.#.#.#.###.#.###.#######.#.#.#.#.###.#.#.#.#.#.#.#.#####.###.#.#.###.#",
    "#.....#.....#.#...#.#.#...#@@@..#@@@..#.#...#.....#.....#@@@..#.#.#...#...#.#.....#.#.#...#...#.......#.....#...........#...#.#...#.......#.......#.#.#...#.#...#.#.#......@@@@@#..@@@#",
    "#.#####.#####.#####.#.###.#########@#.#.#.#.###.#.#.#.#.#@#@#.#####.###.#.#.#.###.#.###.#.#####.###.#####.#####.#.###.###.#.#.#.#.#.###.#.#.#####.#.#.###.###.###.#.#.#.#.#@###@###@#@#",
    "#.....#...#...#.#...#.........#....@@@..........#.#.....#@#@@@@@#.........#...#.....#...#.#.....#.......#.......#.....#.#.#.......#.#...#.#...#.#.........#.........#...#@@@..#@@@@@#@#",
    "#.###.#####.#.#.#.#.#.#######.#.#####@#########.#.#.###.#@#####@#.#####.###.#.#.#.#.###.#.#.#.#.###.#.#####.#.###.###.#.#.#.###.#.#.#.#.#.#.#.#.#.#####.#.#.###.#.#.#.#.#@#.#.###.###@#",
    "#.#...#.#.....#...#.#.#.......#.#....@@@@@@@@@@@@@#...#@@@..#..@@@@@@@@@....#.........#...#.#.#...#.#...#...#.........#.....#...........#.#...........#.....#.#.#.#...#@@@#...#.#.#..@#",
    "#.#.#.#.#.###.#######.#.#.#.###.#.#.#.###.#.#.###@###.#@###.#.#####.#.#@#.#.#.###.#########.#.#.#.#.#.#.#######.###.#.#.###.#.#.###.#.###.#.#.###.#.#.#.#.#.#.#.#.#.###@#####.#.###.#@#",
    "#.#.....#.....#.#.......#...#...#...#.#...#.....#@@@@@@@#...#...#...#.#@#...#...#.....#.#...#...........#.........#...#.#...#...#...#...#...........#.#.#...#..........@#.....#.#..@@@#",
    "###.#.###.#####.#.#.#.#.#.###.#.#.#####.#.#.#.#.#.#.#.###.###.#.#.###.#@###.###.#####.#.#.###.#.#.###.#.#.#.###.#####.###.#####.#.#.###.#.#####.#.#.#.#####.###.###.###@#.#.#.#.#.#@###",
    "#.........#.....#.....#...#...............#.#...#.#.#.....#.#...#...#.#@@@@@@@@@@@@@..#.......#.......#.#...#.#@@@@@@@@@@@#.#.#...............#...#.........#..........@....#...#..@#.#",
    "#.#.#.###.#.#####.#.#.#.#.#.#.###.###.###.#####.#.#####.###.#.#.###.#.###.###.#####@#####.#####.#########.###.#@#.#.#.#.#@#.#.#.#.#.#.###.#.#.###.#####.###.#####.###.#@###.###.#.#@#.#",
    "#.....#.#.............#...#.......#.#.............#.#...#.#...#...#.#.....#.#.#...#@#.....#...#@@@@@@@@@@@#..@@@#.#.#...#@@@@@@@@@@@@@@@....#.....#.....#..........@@@@@#.....#.#..@@@#",
    "#.#####.#.###.#.#######.###.###.#.#.#.###.###.#.###.#.#.#.###.#.#.#.#####.#.###.###@#########.#@#####.#.#@#.#@#.#.#.#####.#########.#.#@#.#.###.###.#.#####.#.#.###@#####.#.#.###.###@#",
    "#...#.....#.#.#.#...............#.........#.....#.......#.........#...........#...#@@@....#.#..@#.......#@@@@@#...#.#...#.#...#.#.....#@@@@@@@@@@@#............@@@@@#...#.#.#.#...#.#@#",
    "#.#.#.#####.#.###.###.#.#.#####.#.#####.###.#.###.#.#######.#.#.###.###.###.#.#.#.#.#@#.#.#.#.#@#.#.#######.#######.#.#.###.###.#.###.#.###.#.#.#@#.#.#######.#@#.###.#.###.#####.#.#@#",
    "#.....#.#.....#...#...#.#.......#...#.............#...#.....#...#.#.......#.....#...#@@@#.#..@@@#.#...........#.......#.#...#...#.#...#.#.#.....#@@@@@@@@@@@@@@@#...#.#.#...#...#..@@@#",
    "#####.#.#.#.###.#.###.#.#####.#######.#############.#.#.#.#.#.###.#.#.###.#.#####.#.#.#@#####@#.#.###.###.#.#.#.###.#.#.###.#.#.#.#.#.#.#.#.#.###.###.#.#######.###.#.#####.#######@###",
    "#.....#...........#.....#.....#.......#...#...#.......#.....#.#...#.#.#...#.#...#.....#@@@@@@@#...#...#...#.#.#.#.....#.....#...#.#...#.......#...#...#.....#...#...#.........#.#..@@B#",
    "#######################################################################################################################################################################################"
  ]
}